[12, 12, 12, 12, 60, 60, 60, 60, 60, 60, 60, 60, 12, 60, 60, 12, 55, 12, 12, 12, 12, 55, 55, 55, 12, 12, 12, 60, 60, 60, 60, 12, 12, 12, 12, 12, 60, 60, 60, 12]
[55, 60, 60, 60, 12, 12, 55, 55, 12, 12, 55, 55, 12, 12, 66, 12, 60, 60, 60, 12, 60, 60, 12, 60, 60, 60, 12, 12, 66, 66, 66, 66, 66, 66, 66, 66, 55, 55, 60, 12]
[12, 60, 66, 55, 55, 55, 55, 55, 55, 12, 55, 55, 55, 55, 66, 60, 60, 12, 55, 55, 55, 55, 55, 12, 12, 12, 12, 55, 66, 66, 12, 12, 66, 66, 66, 55, 55, 55, 60, 60]
[12, 66, 66, 66, 55, 12, 12, 12, 12, 55, 12, 12, 12, 12, 12, 66, 66, 60, 12, 12, 12, 12, 12, 55, 55, 55, 12, 55, 55, 66, 55, 55, 12, 66, 66, 66, 55, 12, 12, 60]
[12, 66, 55, 60, 66, 55, 12, 12, 12, 12, 12, 12, 12, 12, 12, 12, 66, 66, 60, 55, 12, 12, 12, 12, 12, 12, 12, 12, 12, 12, 66, 66, 66, 66, 12, 55, 66, 12, 12, 60]
[55, 66, 12, 60, 66, 55, 55, 12, 12, 12, 12, 12, 12, 12, 55, 12, 66, 66, 60, 12, 55, 55, 12, 12, 12, 12, 12, 12, 12, 12, 12, 12, 12, 12, 66, 55, 66, 66, 55, 60]
[12, 66, 12, 12, 66, 55, 12, 12, 12, 12, 12, 12, 12, 12, 66, 66, 12, 60, 60, 12, 12, 12, 55, 12, 12, 12, 12, 12, 12, 12, 12, 12, 12, 12, 12, 12, 66, 55, 12, 12, 60]
[12, 55, 12, 55, 66, 12, 12, 12, 12, 12, 12, 12, 12, 66, 66, 60, 60, 12, 12, 12, 12, 12, 55, 12, 12, 12, 12, 12, 12, 12, 12, 12, 12, 12, 12, 12, 66, 12, 12, 66, 60]
[12, 66, 55, 66, 12, 12, 12, 12, 12, 12, 12, 12, 12, 66, 60, 12, 55, 12, 12, 12, 12, 12, 55, 12, 12, 12, 12, 12, 12, 12, 12, 12, 12, 12, 12, 55, 66, 12, 12, 66, 60]
[12, 66, 12, 66, 12, 12, 12, 12, 12, 12, 12, 12, 12, 12, 66, 55, 55, 12, 12, 12, 12, 12, 55, 12, 12, 12, 12, 12, 12, 12, 12, 12, 12, 12, 12, 55, 66, 12, 12, 66, 60]
[12, 66, 66, 60, 12, 12, 12, 12, 12, 12, 12, 12, 12, 12, 12, 66, 66, 12, 12, 12, 12, 12, 55, 12, 12, 12, 12, 12, 12, 12, 12, 12, 12, 12, 12, 12, 66, 12, 12, 66]
[12, 66, 66, 60, 12, 12, 12, 12, 12, 12, 12, 12, 12, 12, 12, 55, 66, 66, 12, 12, 12, 55, 12, 12, 12, 12, 12, 12, 12, 12, 12, 12, 12, 12, 12, 12, 66, 12, 12, 66]
[55, 66, 55, 55, 55, 12, 12, 12, 12, 12, 12, 12, 12, 12, 12, 12, 55, 66, 12, 12, 12, 12, 12, 12, 12, 12, 12, 12, 12, 12, 12, 12, 12, 12, 12, 12, 66, 55, 55, 66]
[55, 66, 66, 60, 12, 12, 12, 12, 12, 12, 12, 12, 12, 12, 12, 12, 66, 60, 60, 12, 12, 12, 12, 12, 12, 12, 12, 12, 12, 12, 12, 12, 12, 12, 12, 12, 12, 66, 66, 12]
[55, 55, 66, 55, 12, 12, 12, 12, 12, 12, 12, 12, 12, 12, 12, 66, 12, 60, 12, 12, 12, 12, 12, 12, 12, 12, 12, 12, 12, 12, 12, 12, 12, 12, 12, 12, 12, 66, 66, 12]
[55, 55, 60, 66, 12, 12, 12, 12, 12, 12, 12, 12, 12, 66, 66, 60, 60, 55, 55, 55, 12, 12, 12, 12, 12, 12, 12, 12, 12, 12, 12, 12, 12, 12, 12, 12, 66, 66, 60, 12]
[12, 60, 55, 66, 66, 12, 12, 12, 12, 12, 12, 12, 66, 60, 60, 12, 55, 12, 12, 55, 12, 12, 12, 12, 12, 12, 12, 12, 12, 12, 12, 12, 12, 12, 12, 12, 55, 66, 60, 55]
[12, 12, 55, 66, 12, 66, 12, 12, 12, 12, 60, 60, 66, 55, 12, 12, 55, 12, 12, 12, 55, 12, 12, 12, 12, 12, 12, 12, 12, 12, 12, 12, 12, 12, 12, 12, 55, 66, 55, 60]
[12, 60, 55, 66, 12, 12, 12, 66, 12, 60, 60, 60, 66, 12, 12, 12, 55, 12, 12, 12, 12, 55, 12, 12, 12, 55, 55, 12, 55, 55, 12, 12, 12, 12, 55, 55, 55, 66, 12, 60]
[12, 55, 60, 66, 66, 12, 12, 12, 66, 66, 12, 66, 66, 66, 12, 12, 12, 55, 55, 12, 12, 55, 55, 55, 55, 55, 55, 55, 55, 55, 55, 55, 55, 55, 12, 12, 66, 66, 60, 12]
[12, 55, 60, 60, 66, 12, 55, 55, 12, 60, 55, 55, 55, 60, 55, 55, 12, 66, 66, 66, 66, 66, 66, 55, 12, 12, 66, 66, 66, 66, 12, 55, 12, 55, 12, 55, 66, 55, 60, 12]
[12, 12, 12, 60, 60, 66, 66, 66, 12, 60, 60, 60, 60, 12, 12, 12, 66, 66, 60, 60, 12, 60, 55, 66, 66, 66, 55, 60, 60, 60, 66, 60, 60, 60, 60, 66, 60, 60, 60, 12]
[12, 12, 12, 12, 12, 12, 12, 12, 66, 12, 66, 66, 66, 66, 66, 66, 66, 12, 12, 12, 12, 12, 12, 12, 12, 12, 12, 12, 12, 12, 12, 66, 66, 66, 66, 12, 12, 12, 12, 12]
